old id = 3913
Books | Resources | Greater Good
2003
https://greatergood.berkeley.edu/resources/books

Greater GoodScience Center•Magazine•In Action•In EducationTOPICSKEYS TO WELL-BEINGRESOURCESBOOKSCheck out these books from the Greater Good Science Center, as well as other noteworthy titles on subjects explored by the GGSC.
Scared Sick: The Role of Childhood Trauma in Adult DiseaseRobin Karr-Morse illuminates how the stress of early childhood trauma can hurt your health later in life.
The Happiness of Pursuit: What Neuroscience Can Teach Us About the Good LifeShimon Edelman portrays happiness as a pursuit, since the underlying brain process that support it are constantly in flux.
Living in Gratitude: A Journey That Will Change Your LifeAngeles Arrien explains the benefits of gratitude and offers a month-by-month set of gratitude practices.
The Forgiving Life: A Pathway to Overcoming Resentment and Creating a Legacy of LoveRobert Enright explains how to forgive others and why forgiveness is so beneficial.
Beautiful Souls: Saying No, Breaking Ranks, and Heeding the Voice of Conscience in Dark TimesEyal Press tells the heroic stories of individuals who held to their convictions and behaved with compassion in difficult circumstances.
Imagine: How Creativity WorksJonah Lehrer argues that creativity isn't a gift of the lucky few, but a variety of thought processes we can all learn to cultivate.
Healing the Angry BrainRonald Potter-Efron reveals how understanding the way your brain works can help you control anger and aggression.
Compassion, Inc.
Mara Einstein explores what happens when corporations turn compassion into a commodity.
Talking Back to Facebook: The Common Sense Guide to Raising Kids in the Digital AgeJames Steyer outlines some of the risks involved in online use and what parents can do about them.
How to Bullyproof Your ClassroomCaltha Crowe offers teachers positive ways to create a classroom of caring and prevent bullying.
Rainy Brain, Sunny BrainElaine Fox explores what makes you optimistic or pessimistic—and how to build optimism as a skill.
What Money Can’t Buy: The Moral Limits of MarketsMichael Sandel argues that markets have a place—but it's not in hospitals, daycare centers, schools, or families.
Dreamland: Adventures in the Strange Science of SleepDavid K. Randall reveals the scientific and personal importance of sleep—and provides some tips to get more of it.
The 7 Laws of Magical Thinking: How Irrational Beliefs Keep Us Happy, Healthy, and SaneMatthew Hutson argues that humans have evolved for superstition—and that it can benefit our mental and physical health.
Teach Your Children Well: Parenting for Authentic SuccessMadeline Levine helps parents avoid pushing their kids toward extreme achievement and (the consequences of that approach).
The Moral Molecule: The Source of Love and ProsperityPaul Zak argues that the success of an economic system may lie with trust—and the hormone oxytocin.
How Children Succeed: Grit, Curiosity, and the Hidden Power of CharacterTough makes the case that character traits such as grit, curiosity, conscientiousness, and optimism are more vital to success than IQ.
Far From the Tree: Parents, Children and the Search for IdentityAndrew Solomon explores extreme differences between parents and children—and how we can find meaning in life's most difficult experiences.
A Mindful NationTim Ryan shows how mindfulness can help us with both our individual struggles and our societal problems.
The Righteous Mind: Why Good People Are Divided by Politics and ReligionJonathan Haidt explains where moral judgments come from and how this creates conflicts around politics and religion.
The Storytelling Animal: How Stories Make Us HumanJonathan Gotschall shows how stories may serve an evolutionary purpose by helping us navigate our complex social world.
Search Inside Yourself: The Unexpected Path to Achieving Success, Happiness (and World Peace)Chade-Meng Tan explains how to enhance mindfulness and emotional intelligence in life and work.
Wellbeing in the Primary Classroom: A Practical Guide to Teaching HappinessAdrian Bethune offers a guide for supporting the mental and emotional well-being of primary school students.
The Emotional Life of Your BrainRichard Davidson and Sharon Begley reveal the six neurological dimensions that are most influential on our health and happiness.
Quiet: The Power of Introverts in a World That Can’t Stop TalkingSusan Cain reveals the often-overlooked benefits of introversion, like creativity, innovation, and perseverance.
Moral Origins: The Evolution of Virtue, Altruism, and ShameChristopher Boehm offers a new evolutionary theory about how humans developed altruism and a conscience.
Mindful Birthing: Training the Mind, Body, and Heart for Childbirth and BeyondNancy Bardacke argues that mindfulness can help women (and their partners) navigate pregnancy and childbirth.
Peace in the Heart and HomeCharlette Mikulka explains how to reduce stress and use mind-body techniques to manage the emotional challenges of family life.
Happier at HomeGretchen Rubin chronicles her experiments aimed at boosting happiness in her family relationships, possessions, and time at home.
Subliminal: How Your Unconscious Mind Rules Your BehaviorLeonard Mlodinow illustrates how unconscious processes shape our experiences and relationships.
Resilience: Why Things Bounce BackAndrew Zolli and Ann Marie Healy reveal eight principles of resilience that help us heal and reorganize in the face of adversity.
Wait: The Art and Science of DelayFrank Partnoy explains why people who master the art of waiting and delayed gratification are often more successful in life.
Incognito: The Secret Lives of the BrainDavid Eagleman shows how our subconscious mind filters reality for us, affecting what we perceive and how we behave.
The Little Book of Heartbreak: Love Gone Wrong Through the AgesMeghan Laslocky explores what heartbreak looks like throughout history, in art, and in the brain.
The Social Neuroscience of Education: Optimizing Attachment and Learning in the ClassroomLouis Cozolino explains how our social brains work and how teachers can apply this knowledge to benefit student learning.
The Myths of HappinessSonja Lyubomirsky explains the common but mistaken assumptions that get in our way when we're trying to become happier.
Sticks and StonesEmily Bazelon explores bullying among kids—and finds the solution in fostering empathy among both kids and adults.
Executive Function & Child DevelopmentMarcie Yeager and Daniel Yeager explain how to help kids mature and improve their executive functioning without relying on punishments.
Ecoliterate: How Educators Are Cultivating Emotional, Social, and Ecological IntelligenceDaniel Goleman, Lisa Bennett, and Zenobia Barlow explain how educators can teach kids to care deeply about the environment.
Give and Take: Why Helping Others Drives Our SuccessAdam Grant argues that giving to others is a key strategy for success in business as well as in life.
World Peace and Other 4th-Grade AchievementsJohn Hunter shares lessons learned from teaching his World Peace Game, where students use collaboration to solve big global problems.
Pieces of Light: How the New Science of Memory Illuminates the Stories We Tell About Our PastsCharles Fernyhough provides an overview of how memory works and debunks misconceptions about it.
Mastermind: How to Think Like Sherlock HolmesMaria Konnikova explains the neuroscience of clear thinking, astute observation, problem solving, and creative insight.
99 Blessings: An Invitation to LifeBrother David Steindl-Rast, a Benedictine monk, offers a collection of prayers for people of all faiths.
Mindful CompassionPaul Gilbert and Choden highlight how mindfulness can help improve social relationships and nurture compassion toward oneself and others.
Happy Money: The Science of Smarter SpendingElizabeth Dunn and Michael Norton explain how money can make you happier if you spend it the right way.
Mind Whispering: A New Map to Freedom from Self-Defeating Emotional HabitsTara Bennett-Goleman applies mindfulness to overcoming self-defeating habits of mind and improving our relationships.
When Will My Grown-Up Kid Grow Up?: Loving and Understanding Your Emerging AdultJeffrey Arnett and Elizabeth Fishel explore how to parent today's young adults, who are struggling to become established and independent.
Animal Wise: The Thoughts and Emotions of Our Fellow CreaturesVirginia Morell travels around the world and meets researchers who are discovering that animals can think and feel much as humans can.
The SharpBrains Guide to Brain Fitness: How to Optimize Brain Health and Performance at Any AgeAlvaro Fernandez and Elkhonon Goldberg explore how to optimize brain health through all the stages of life.
Love 2.0: How Our Supreme Emotion Affects Everything We Feel, Think, Do, and BecomeFredrickson argues that love exists in micro-moments of connection and can be consciously cultivated in every sphere of life.
What Makes a Hero?: The Surprising Science of SelflessnessElizabeth Svoboda explores what prompts people to act altruistically and how to make heroic action more likely.
Emotional Readiness: How Early Experience and Mental Health Predict School SuccessTerrie Rose argues that we should focus more on young kids' emotional skills rather than academics.
Hardwiring Happiness: The New Brain Science of Contentment, Calm, and ConfidenceRick Hanson explains how to turn momentary positive experiences into lasting inner strengths in our brains.
What Doctors Feel: How Emotions Affect the Practice of MedicineDanielle Ofri illustrates the challenges doctors face in managing their emotions under life-and-death circumstances.
Ungifted: Intelligence RedefinedScott Barry Kaufman argues that other factors, besides IQ, are important in academic success and in life.
Moral Tribes: Emotion, Reason, and the Gap Between Us and ThemJoshua Greene explains why we disagree on moral issues and how to transcend our differences to find solutions to big problems.
Focus: The Hidden Driver of ExcellenceDaniel Goleman argues that focus leads to greater happiness, better relationships, and increased productivity.
Social: Why Our Brains Are Wired to ConnectMatthew Lieberman shows how central social connection is to our lives (and brains), and what that means for our well-being.
Just Babies: The Origins of Good and EvilPaul Bloom argues that we are born with a bias toward goodness and connection with others.
Bouncing Back: Rewiring Your Brain for Maximum Resilience and Well-BeingLinda Graham shows us how to handle adversity in a more positive and resilient way.
The Bonobo and the AtheistFrans de Waal argues that moral behavior is part of our evolutionary heritage, not predicated on religion.
The Myths of HappinessSonja Lyubomirsky explains how understanding our misconceptions about happiness can ultimately lead to a rich and meaningful life.
The Tell: The Little Clues That Reveal Big Truths about Who We AreMatthew Hertenstein explores how powerful the human mind can be at gaining split-second information from nonverbal cues.
Scarcity: Why Having Too Little Means So MuchSendhil Mullainathan and Eldar Shafir explain the drawbacks of a scarcity mindset for our brains and how to overcome it.
Profit from the PositiveMargaret Greenberg and Senia Maymin explain how businesses can succeed by focusing on strengths, opportunities, aspirations, and results.
Practicing Positive Leadership: Tools and Techniques That Create Extraordinary ResultsKim Cameron identifies four main strategies to help organizations flourish: positive social climate, relationships, communication, and meaning.
Love Sense: The Revolutionary New Science of Romantic RelationshipsSue Johnson outlines the benefits of loving relationships throughout our lives and offers practical tips for couples.
Friendfluence: The Surprising Ways Friends Make Us Who We AreCarlin Flora maps the different forms of friendship and shows how friends impact our health and happiness.
Compassion: Bridging Practice and ScienceTania Singer and Matthias Bolz summarize what we know about compassion and how it can be trained.
All Joy and No Fun: The Paradox of Modern ParenthoodJennifer Senior explores why contemporary parenthood can be so stressful—and at the same time so meaningful.
Mindwise: How We Understand What Others Think, Believe, Feel, and WantNicholas Epley illustrates the mistakes we often make when trying to understand and empathize with other people.
The App GenerationHoward Gardner and Katie Davis explore how apps are shaping young people's lives for better and worse.
Thrive: The Third Metric to Redefining Success and Creating a Life of Well-Being, Wisdom, and WonderArianna Huffington attempts to redefine success as well-being rather than power or money—and shares her efforts to pursue it.
Making Grateful Kids: The Science of Building CharacterJeffrey Froh and Giacomo Bono argue that parents can foster gratitude in kids—but it takes effort and time.
The Truth About Trust: How It Determines Success in Life, Love, Learning, and MoreDavid DeSteno argues that it's hard to tell who is trustworthy—or when to trust ourselves—at any given moment.
Ha!: The Science of When We Laugh and WhyScott Weems explains what humor is, how things become funny, and why evolution gave us laughter.
Mindful Discipline: A Loving Approach to Setting Limits and Raising an Emotionally Intelligent ChildShauna Shapiro and Chris White explain how parents can combine firm boundaries with loving connection.
The Way of Mindful Education: Cultivating Well-Being in Teachers and StudentsDaniel Rechtschaffen explains how to create a mindful classroom, including sample lessons and curricula.
Why Won’t My Teenager Talk to Me?John Coleman explains the many reasons why teens seem to shut down, and how to get them to open up.
Brainstorm: The Power and Purpose of the Teenage BrainDaniel Siegel reveals how the brain changes during adolescence and how we can celebrate and support teen development.
The Myth of the Spoiled Child: Challenging the Conventional Wisdom about Children and ParentingAlfie Kohn questions the idea that today's kids are more spoiled and narcissistic than previous generations.
Supersurvivors: The Surprising Link Between Suffering and SuccessDavid Feldman and Lee Daniel Kravetz explain why some people seem to bounce back and even excel after trauma.
Powers of Two: How Relationships Drive CreativityJoshua Wolf Shenk argues that creativity is often a social endeavor, rather than the work of a lone genius.
The Good Life: Wellbeing and the New Science of Altruism, Selfishness, and ImmoralityGraham Music explores what we know about human nature and the role of the environment in shaping our moral character.
The Upside of Your Dark SideKashdan and Biswas-Diener show that emotions like anger, anxiety, guilt, and sadness can be useful.
Age of Opportunity: Lessons from the New Science of AdolescenceSteinberg argues that America’s approach to raising adolescents misunderstands the science of teen development.
8 Keys to End Bullying: Strategies for Parents & Schools (8 Keys to Mental Health)Whitson synthesizes what we know about bullying into simple, targeted strategies for educators, professionals, and parents.
Teach, Breathe, Learn: Mindfulness In and Out of the ClassroomSrinivasan highlights how mindfulness can be an effective tool in the classroom for teachers and students.
Sitting Together: Essential Skills for Mindfulness-Based PsychotherapyPollak, Pedulla, and Siegel help therapists choose and adapt mindfulness practices for their patients.
The Invisible Classroom: Relationships, Neuroscience & Mindfulness in SchoolOlson helps teachers understand the neurobiological, emotional, and social factors that underlie their students’ school experiences.
Survival of the Nicest: How Altruism Made Us Human and Why It Pays to Get AlongKlein argues that selflessness, not selfishness, creates more genetic success—a challenge to the “survival of the fittest” model in evolution.
The Interpersonal Neurobiology of Play: Brain-Building Interventions for Emotional Well-BeingKestly teaches therapists about the neurobiology of play so they can offer the benefits of play therapy to clients.
It’s Complicated: The Social Lives of Networked Teensboyd uncovers the myths and portrays the reality of teens' lives on social media.
Kitty Genovese: The Murder, the Bystanders, the Crime that Changed AmericaCook uncovers the true story of Kitty Genovese's murder, the crime that led to the bystander effect theory.
Positive Computing: Technology for Wellbeing and Human PotentialCalvo and Peters investigate "positive computing," the design and development of technology to support psychological well-being and human potential.
Is That Me Yelling?: A Parent’s Guide to Getting Your Kids to Cooperate Without Losing Your CoolRona Renner offers effective communication strategies—tailored to your child's temperament—to help improve their behavior.
Empathy: Why It Matters, and How to Get ItRoman Krznaric outlines the six habits of highly empathic people, which can help us be happier, more creative, and more connected.
Rethinking Positive Thinking: Inside the New Science of MotivationGabriel Oettingen debunks the myth that positive thinking—or daydreaming and wishful thinking—can make you successful.
Awakening Joy: 10 Steps to HappinessJames Baraz teaches practices that will bring you more happiness, resilience, and joy, inspired by Buddhist philosophy.
Neurobiology and the Development of Human Morality: Evolution, Culture, and WisdomDarcia Narvaez offers an alternative vision of moral development and flourishing that takes into account bottom-up biological and cultural influences.
Chasing the Scream: The First and Last Days of the War on DrugsJohann Hari goes on a journey to discover what really causes addiction and what really solves it.
The Opposite of Spoiled: Raising Kids Who Are Grounded, Generous, and Smart About MoneyRon Lieber explains how parents can teach their kids to have a healthier relationship with money.
The Best Place to Work: The Art and Science of Creating an Extraordinary WorkplaceRon Friedman provides leaders and employees with useful tips for restructuring work environments to increase innovation, efficiency, and joy.
Driven to Distraction at Work: How to Focus and Be More ProductiveEdward Hallowell explains why we get so distracted at work—and how we can become more focused and productive.
Mindful Work: How Meditation Is Changing Business from the Inside OutDavid Gelles uncovers how mindfulness meditation is going mainstream in large and small organizations around the country.
Mindfulness for Teachers: Simple Skills for Peace and Productivity in the ClassroomPatricia Jennings explains how mindfulness can help teachers manage stress, enhance the classroom environment, and improve teaching and learning.
Touch: The Science of Hand, Heart, and MindDavid Linden explores the science of touch, and finds that it is inextricably linked to how we feel and communicate.
Does Altruism Exist?: Culture, Genes, and the Welfare of OthersDavid Sloan Wilson argues that it is group needs, not individual intention and virtue, that drive altruism.
Surprise: Embrace the Unpredictable and Engineer the UnexpectedTania Luna and Leeann Renninger explore the science and practice of engineering surprise—at work, at home, and in our relationships.
Caring EconomicsTania Singer and Mattheiu Ricard bring together economists, scientists, and Buddhists to explore the spiritual dimensions of the economy.
Changing Your Company from the Inside Out: A Guide for Social IntrapreneursGerald Davis and Christopher White explains how to move your organization in a more socially and environmentally responsible direction.
The Brain’s Way of HealingNorman Doidge explores the frontiers of treatment for conditions like autism, chronic pain, and depression that harness the brain's neuroplasticity.
The Power of Ideals: The Real Story of Moral ChoiceWilliam Damon and Anne Colby argue that morality is dependent on conscious, deliberate processes rather than emotions.
The Working Dad’s Survival Guide: How to Succeed at Work and at HomeScott Behson provides advice to busy fathers who want to pursue their careers and be loving, involved, hands-on dads.
A Force for Good: The Dalai Lama’s Vision for Our WorldDaniel Goleman translates the Dalai Lama’s vision for a compassionate world and explores the science behind it.
The Well-Tuned Brain: Neuroscience and the Life Well LivedPeter Whybrow explains why we sometimes act against our best interests—and what we can do to change course.
The Mindful Teen: Powerful Skills to Help You Handle Stress One Moment at a TimeDzung Vo tries to introduce teens to mindfulness and help them apply it to their lives.
The Sweet Spot: How to Find Your Groove at Home and WorkChristine Carter shares the best habits and strategies for feeling strong, at ease, and less stressed.
Character Strengths Matter: How to Live a Full LifeThis edited volume offers an overview of character strengths and suggests ways we can cultivate them in everyday life.
Modern RomanceAziz Ansari explores the ups and downs of online dating and how romance has changed in the age of technology.
The Spiritual Child: The New Science on Parenting for Health and Lifelong ThrivingLisa Miller explores how to raise children with a sense of awe and transcendence.
Altruism: The Power of Compassion to Change Yourself and the WorldMatthieu Ricard argues that altruism is the path to well-being and the solution to society's major challenges in the 21st century.
The Most Good You Can Do: How Effective Altruism Is Changing Ideas About Living EthicallySinger makes the philosophical case for effective altruism, a way of giving based on reasoned evaluation rather than emotion.
Doing Good Better: How Effective Altruism Can Help You Make a DifferenceMacAskill argues that we should temper our emotional motivations for giving with reason and analysis.
Triumph of the Heart: Forgiveness in an Unforgiving WorldMegan Feldman Bettencourt explores why we forgive and how forgiveness can help us.
Unfair: The New Science of Criminal InjusticeAdam Benforado explains the inherent flaws in our criminal justice system that harm the innocent rather than serving justice and safety.
8 Keys to ForgivenessRobert Enright outlines the basic steps involved in following the difficult, delicate path of forgiveness.
Broadcasting Happiness: The Science of Igniting and Sustaining Positive ChangeMichelle Gielan explains how to spread positivity and combat negativity by changing the way we communicate and receive information.
The Danish Way of ParentingJessica Alexander and Iben Sandahl distill six principles of parenting from one of the world's happiest countries.
One Second Ahead: Enhance Your Performance at Work with MindfulnessRasmus Hougaard and Jacqueline Carter teach us how to integrate mindfulness into work to combat stress and distractions.
Why Therapy Works: Using Our Minds to Change Our BrainsLouis Cozolino argues that talk therapy works by tapping into our hardwired human needs for connection, understanding, and belonging.
Our Kids: The American Dream in CrisisRobert Putnam shows how inequality of opportunity is hurting American youth and offers some social and political solutions.
Reclaiming Conversation: The Power of Talk in a Digital AgeSherry Turkle explains why conversations are so vital for our relationships, creativity, and productivity, and how to save them from technology.
The Giving Way to Happiness: Stories and Science Behind the Life-Changing Power of GivingJenny Santi explains how to donate your time and money in the most rewarding ways.
Well Designed LifeKyra Bobinet applies the principles of modern design to creating a mindful, healthy, and purposeful life.
Friend & Foe: When to Cooperate, When to Compete, and How to Succeed at BothAdam Galinsky and Maurice Schweitzer explore how our psychology impacts our decisions to cooperate or compete, in business and beyond.
The Wisest One in the Room: How You Can Benefit from Social Psychology’s Most Powerful InsightsThomas Gilovich and Lee Ross summarize the most important insights from social psychology to show why people behave the way they do.
The Gratitude Diaries: How a Year Looking on the Bright Side Can Transform Your LifeJanice Kaplan recounts her journey learning the science of gratitude and applying it to her everyday life.
The Joy of Half a Cookie: Using Mindfulness to Lose Weight and End the Struggle with FoodJean Kristeller explains how we can use mindfulness practices to eat wisely and enjoy our special treats more.
Wired to Create: Unraveling the Mysteries of the Creative MindScott Barry Kaufman and Carolyn Gregoire explore how to develop creativity as a habit and a way of life.
Marital Conflict and Children: An Emotional Security PerspectiveE. Mark Cummings and Patrick T. Davies explain how parental conflicts affect children and how to resolve them without causing harm.
Self-Compassion in Psychotherapy: Mindfulness-Based Practices for Healing and TransformationTim Desmond offers strategies for psychotherapists to integrate the science of self-compassion into clinical treatment.
Beyond Measure: Rescuing an Overscheduled, Overtested, Underestimated GenerationVicki Abeles argues that overscheduling and overtesting our kids isn't helping them learn better—and is hurting their health and happiness.
Rising Strong: The Reckoning. The Rumble. The RevolutionBrené Brown explores how brave and vulnerable people practice resilience by confronting their emotions and their stories.
The Importance of Being Little: What Preschoolers Really Need From GrownupsErika Christakis argues that preschools shouldn't teach academics, but offer a responsive, natural environment that feeds kids' curiosity.
The Happiness Track: How to Apply the Science of Happiness to Accelerate Your SuccessEmma Seppälä explains how to use the science of happiness to preserve your energy and be more productive.
The Altruistic Brain: How We Are Naturally GoodDonalf Pfaff suggests that altruism is hardwired into our brains, not immorality and selfishness.
Smart Change: Five Tools to Create New and Sustainable Habits in Yourself and OthersArt Markman explores how to change our own habits and how to influence other people's.
Moving Toward Global CompassionPaul Ekman explains how to extend compassion beyond our circle of family and friends, across social and geographical lines.
Success and Luck: Good Fortune and the Myth of MeritocracyRobert Frank debunks the myth of meritocracy and offers recommendations for creating a more equitable society.
Wired To Connect: The Surprising Link Between Brain Science and Strong, Healthy RelationshipsAmy Banks argues that it’s time for Americans to make more time for their relationships—and not worry so much about independence.
Smarter Faster Better: The Secrets of Being Productive in Life and BusinessCharles Duhigg distills how happy and productive people think: how they motivate themselves, stay focused, absorb information, and make decisions.
Grit: The Power of Passion and PerseveranceAngela Duckworth argues that grit is the key to overcoming difficulty and achieving success.
Life on Purpose: How Living for What Matters Most Changes EverythingVictor Strecher explores how and why to cultivate purpose, drawing on philosophy, science, and personal stories (including his own).
Into the Magic ShopIn this memoir, Jim Doty explains how learning mindfulness and compassion helped him overcome childhood adversity and poverty.
UnSelfie: Why Empathetic Kids Succeed in Our All-About-Me WorldMichele Borba offers tips for parents, teachers, and other caring adults to help encourage children to develop empathy and generosity toward others.
The Moral Economy: Why Good Incentives Are No Substitute for Good CitizensSamuel Bowles argues that incentives aren't the only driver of good behavior; instead, we should promote norms of fairness and trust.
Becoming Wise: An Inquiry into the Mystery and Art of LivingTippett shares insights from modern thinkers in a quest to bring together our fractured world in civility and love.
The Anxious LawyerCho and Gifford offer an eight-week guide to mindfulness and meditation to make your law practice more satisfying and joyful.
Growing Up MindfulWillard explains what parents and teachers can do to encourage kids to be more mindful.
Overcoming Destructive Anger: Strategies That WorkGolden outlines the nature of anger—what triggers it, how it affects us, and what we can do to manage it effectively.
This Is Where You Belong: The Art and Science of Loving the Place You LiveWarnick explores what it means to settle down and love where you live.
Splitopia: Dispatches from Today’s Good Divorce and How to Part WellParis challenges our negative assumptions about divorce and offers tips for a happier, healthier split.
Self-Reg: How to Help Your Child (and You) Break the Stress Cycle and Successfully Engage with LifeShanker outlines steps that parents can take to deal with problematic behavior or anxiety in their children more effectively.
Tribe: On Homecoming and BelongingJunger explores the loneliness and alienation of modern society and the haunting question of why soldiers miss war upon their return home.
Push Back: Guilt in the Age of Natural ParentingTuteur takes aim at the logic and evidence for natural childbirth, breastfeeding, and attachment parenting.
All on One Plate: Cultural Expectations on American MothersBrown shares insights from her interviews with mothers about their beliefs about mothering, the strain they face, and their attempts to cope.
Becoming Brilliant: What Science Tells us About Raising Successful ChildrenGolinkoff and Hirsh-Pasek argue that education should focus on collaboration, communication, content, critical thinking, creativity, and confidence.
Awakening Joy for KidsBaraz and Lilyanna offer a guide to helping your children increase their presence, self-compassion, openness, and well-being.
The Fix: How Nations Survive and Thrive in a World in DeclineTepperman gathers insights from world leaders on how to solve seemingly intractable societal problems, from inequality to political divisions.
Mindful Games: Sharing Mindfulness and Meditation with Children, Teens, and FamiliesGreenland offers mindfulness exercises for children that teach attention, balance, and compassion.
Messy: The Power of Disorder to Transform Our LivesHarford suggests how embracing disorder can improve our creativity, innovation, problem-solving, and resilience.
Be the Boss Everyone Wants to Work For: A Guide for New LeadersGentry explains the mindset and skill set required to be a leader—someone devoted to the good of the group rather than personal advancement.
The Distracted Mind: Ancient Brains in a High-Tech WorldGazzaley and Rosen explain why our brains struggle with technology and multitasking, and how to cope better with distractions.
Are We Smart Enough to Know How Smart Animals Are?de Waal questions our intellectual superiority to other animals by showing all the ingenious ways animals adapt to their environments.
Opening Up by Writing It Down: How Expressive Writing Improves Health and Eases Emotional PainPennebaker and Smyth survey the scientific history of the expressive writing practice, its benefits, and how to make it work for you.
Changing to ThriveThe Prochaskas examine the common psychological barriers to change—and how to overcome them.
Take Pride: Why the Deadliest Sin Holds the Secret to Human SuccessTracy argues that we evolved to feel pride because it serves an important social function.
Helping Children Succeed: What Works and WhyTough argues children will develop the qualities they need to succeed if they have the right environmental supports in their families and schools.
Joy on Demand: The Art of Discovering the Happiness WithinTan teaches mindfulness by emphasizing ease, joy, and jokes.
The Happiness Track: How to Apply the Science of Happiness to Accelerate Your SuccessSeppälä explains how to use the science of happiness to preserve your energy and be more productive.
The Power Paradox: How We Gain and Lose InfluenceKeltner explains the secret to gaining and keeping power: focus on the good of others.
Strangers in Their Own Land: Anger and Mourning on the American RightHochschild offers a sociological portrait of the conservative right, going beyond stereotypes to understand their deeper emotions and motivations.
The Gardener and the CarpenterGopnik draws on cognitive science, evolutionary theory, and philosophy to explain how children develop and what they really need from adults.
Success and Luck: Good Fortune and the Myth of MeritocracyFrank debunks the myth of meritocracy and offers recommendations for creating a more equitable society.
Peak: Secrets from the New Science of ExpertiseEricsson and Pool distill the specific habits that lead to top performance, arguing that innate talent is less important than we think.
America the Anxious: How Our Pursuit of Happiness Is Creating a Nation of Nervous WrecksWhippman investigates the American obsession with happiness and tries to figure out why it doesn’t seem to work.
Invisible Influence: The Hidden Forces that Shape BehaviorBerger shows us the insidious way other people’s opinions affect us, including what we see, buy, and believe.
Mastering Civility: A Manifesto for the WorkplacePorath makes the case that practicing civility at the office is the path to better relationships and higher productivity.
Fostering Empathy Through MuseumsGokcigdem showcases a variety of museums and programs that are fostering empathy through education, design, and experiential learning.
The Creativity Challenge: How We Can Recapture American InnovationKim addresses how to combat the trend of declining creativity in America in our workplaces and beyond.
Raising a Secure ChildHoffman, Cooper, and Powell suggest that parents can raise healthier and happier children by providing a balance of support and freedom.
The Nature Fix: Why Nature Makes us Happier, Healthier, and More CreativeWilliams shows how nature impacts our health, creativity, and happiness, arguing that we should incorporate more green spaces into our lives.
The Leading Brain: Powerful Science-Based Strategies for Achieving Peak PerformanceFabritius and Hagemann show how we can apply advances from neuroscience to work smarter and happier.
Buddhist Economics: An Enlightened Approach to the Dismal ScienceBrown argues for integrating the Buddhist values of relieving suffering, interdependence with others, and sustainability into the economy.
Creative Change: Why We Resist It . . . How We Can Embrace ItMueller explains how uncertainty can get in the way of embracing creativity, and how to be more open to creative ideas.
The Power of Meaning: Crafting a Life That MattersSmith uncovers the four pillars of living a meaningful life: belonging, purpose, transcendence, and storytelling.
The Ostrich Paradox: Why We Underprepare for DisastersMeyer and Kunreuther outline the psychological biases that get in the way of good decision-making—and what to do about them.
Awakening Compassion at Work: The Quiet Power That Elevates People and OrganizationsWorline and Dutton explain why showing compassion in the workplace can help employees and businesses to thrive.
Attending: Medicine, Mindfulness, and HumanityEpstein explains how mindfulness allows doctors to listen attentively, make good judgments, and act compassionately.
What Patients Say, What Doctors HearOfri offers listening and communication skills that can help doctors improve their patient care.
The Compassionate Achiever: How Helping Others Fuels SuccessKukk explains why and how you can achieve success by practicing compassion, altruism, and kindness.
The Developmental Science of Early ChildhoodGold helps parents understand their kids better by looking beyond behavior to the larger forces in the family and the child's biology.
The Future of HappinessBlankson argues that technology can make our lives happier and more productive—but only if we use it intentionally.
Mindshift: Break Through Obstacles to Learning and Discover Your Hidden PotentialOakley offers readers a course in learning how to learn, debunking the myths that hold us back from transformative growth.
Rest: Why You Get More Done When You Work LessPang explains the benefits of rest for productivity and innovation, and what we can do to rest more effectively.
The Craving MindBrewer shows how mindfulness and meditation can help counter everyday cravings that lead to bad habits and addictions.
U Thrive: How to Succeed in College (and Life)Lerner and Schlechter offer a wide range of strategies for happiness and success, based on their popular college course.
Overcoming Bias: Building Authentic Relationships across DifferencesJana and Freeman explain how to mitigate the impact of unconscious biases and forge meaningful connections with others.
Another Kind of Madness: A Journey Through the Stigma and Hope of Mental IllnessHinshaw's memoir explores how his father's psychosis affected his life, and argues for reducing the stigma around mental illness.
The Happy Traveler: Unpacking the Secrets of Better VacationsKurtz draws on the science of happiness and decision making to help us have happier vacations.
Awkward: The Science of Why We’re Socially Awkward and Why That’s AwesomeTashiro explains why some people are more socially awkward and how they can use their strengths to connect with othersThe Weekend EffectOnstad explains how we lost our work-life balance, why it matters, and what to do about it.
Stick with It: A Scientifically Proven Process for Changing Your Life-for GoodYoung explains why changing our habits and behaviors can be difficult and offers practical strategies for lasting transformation.
Barking Up the Wrong TreeBarker offers strategies for achieving any kind of success—whether you want to boost your productivity, income, or expertise.
Altered Traits: Science Reveals How Meditation Changes Your Mind, Brain, and BodyGoleman and Davidson uncover the best mindfulness research to show how long-term meditation can profoundly improve your mind, brain, and body.
The Asshole Survival Guide: How to Deal with People Who Treat You Like DirtSutton explains how to deal with toxic relationships at work.
How to Be Happy at Work: The Power of Purpose, Hope, and FriendshipMcKee argues that our jobs can be happier if we focus on seeking purpose, hope, and positive relationships at work.
Braving the Wilderness: The Quest for True Belonging and the Courage to Stand AloneBrown identifies the roots of true belonging, and how our society can move past shame and hate toward empathy and connection.
Born to Be Wild: Why Teens Take Risks, and How We Can Help Keep Them SafeShatkin explains why teens take risks, and how parents and teachers can help them make better choices and stay safe.
Careful: A User’s Guide to Our Injury-Prone MindsCasner reveals how our minds make us careless and what we can do to prevent injury.
iGenTwenge uses large-scale surveys to draw a detailed portrait of today’s teens and the unique cultural forces shaping them.
Why We Sleep: Unlocking the Power of Sleep and DreamsWalker explains how we can harness the transformative power of sleep to change our lives for the better.
The All-or-Nothing Marriage: How the Best Marriages WorkFinkel charts the historical course of marriage and offers three strategies for a flourishing modern partnership.
The Power of Moments: Why Certain Experiences Have Extraordinary ImpactThe Heaths argue that peak moments are essential to happiness and explain how to create more of them at work and in our personal lives.
The Influential Mind: What the Brain Reveals About Our Power to Change OthersSharot explains how our attempts to influence others work (or don’t work) in the brain, so we can better persuade and motivate others.
Behave: The Biology of Humans at Our Best and WorstSapolsky offers a synthesis of how biology shapes human behavior—both the good and the bad—and how that explains larger societal problems.
The Strength SwitchWaters guides parents to see their children's positive attributes rather than their flaws, with real-life examples and practical exercises.
Happier?: The History of a Cultural Movement That Aspired to Transform AmericaHorowitz takes a tour of the history, criticisms, and future of the positive psychology movement.
When Grit Isn’t EnoughNathan offers solutions for educators and mentors who want to help low-income and first-generation students succeed in college or careers.
Emotional Success: The Power of Gratitude, Compassion, and PrideDeSteno shows how gratitude, compassion, and pride—rather than willpower and self-denial—can help us cultivate grit and achieve our goals.
Before You Know It: The Unconscious Reasons We Do What We DoBargh explains how unconscious motivations and environmental cues influence how we act, and how to harness them to create good habits.
Great at Work: How Top Performers Do Less, Work Better, and Achieve MoreHansen uncovers the best strategies you can use at work to be happier and more successful.
No More Mean Girls: The Secret to Raising Strong, Confident, and Compassionate GirlsHurley explains how to counter bullying and relational aggression and help young girls with friendship building, authenticity, and courage.
The Organized Child: An Effective Program to Maximize Your Kid’s Potential—in School and in LifeSpira, Rosenblatt, and Gallagher explain how to improve your kids’ organization, time management, and planning skills.
The Kindness Cure: How the Science of Compassion Can Heal Your Heart and Your WorldCousineau argues that we are wired for kindness and offers guidelines for starting a kindness revolution—and overcoming barriers along the way.
What We Think About When We Try Not to Think About Global WarmingStoknes explains how to reframe the debate around climate change and turn apocalypse fatigue into personal and societal action.
Doing HarmDusenbery book exposes the gender disparities in medicine that lead to poorer outcomes for women and the systemic causes of these disparities.
How We Work: Live Your Purpose, Reclaim Your Sanity, and Embrace the Daily GrindWeiss offers mindfulness practices to sharpen your abilities, enhance your leadership and interpersonal skills, and boost your satisfaction at work.
Resilient: How to Grow an Unshakable Core of Calm, Strength, and HappinessThe Hansons teach positive neuroplasticity—how to boost resilience by turning passing experiences into lasting inner resources.
How to Be Yourself: Quiet Your Inner Critic and Rise Above Social AnxietyHendriksen argues that socially anxious people can get relief and make connections with others, without a major personality change.
Alive at Work: The Neuroscience of Helping Your People Love What They DoCable leverages neuroscience to explain why work is a slog—and how to bring back our curiosity and excitement.
When: The Scientific Secrets of Perfect TimingPink explains the psychology of time and how to harness it for greater success and well-being.
Gratitude: A Way of TeachingThis valuable book will give educators solution-based methods and research-based resources to improve classroom culture, as well as enabling…Mindfulness for TeachersA leading expert on mindfulness in education explains how teachers can manage the stresses of their classrooms and foster well-being in…Mindful DisciplinePsychologist Shauna Shapiro and pediatrician Chris White weave together ancient wisdom and modern science to provide new perspectives on…Making Grateful KidsTwo experts explain how to foster gratitude in children, drawing on new research and compelling real-life stories.
Gratitude Works!The world's leading scientific expert on gratitude offers a step-by-step guide to becoming a more grateful person.
The Emotional Life of Your BrainDavidson, a pioneering neuroscientist, and Begley, a leading science journalist, explain how we each have specific, identifiable brain…The Forgiving LifeGuides readers through the path to forgiveness, drawing on Enright's decades of research.
A Simple Act of GratitudeA memoir on how a man's resolution to write 365 thank you letters in one year changed his life.
Moral OriginsOur moral sense is a defense mechanism. From the days of Darwin to today, biologists--and now Boehm--understand altruism as the key to…Mindful BirthingBardacke shares the science and stories behind her Mindfulness-Based Childbirth and Parenting Program, and explains how to incorporate…The Moral MoleculeA look at the hormone oxytocin's role in trust and how that may be the basis of a well-functioning economic system.
Empathy: Philosophical and Psychological PerspectivesA collection of philosophy/psychology sources revealing how important it is to bring to bear an understanding of the role of empathy in its…EmpathyThis edited volume explores current research on empathy, theories about empathy, and the relationship between empathy and clinical and…The Anatomy of HopeWhy do some people find and sustain hope during difficult circumstances, while others do not? What can we learn from those who do, and how is…FlourishRedefining what Positive Psychology is all about, Seligman now considers, What is it that enables you to cultivate your talents, to build…The Social AnimalThe hidden sources of love, character, and achievement. Brooks explores the unconscious mind and how it shapes the way we live.
The Better Angels of Our NaturePinker's controversial claim: Violence has been diminishing for millennia and we may be living in the most peaceful time in our species's…Unconditional ParentingKohn argues that when we rely on external motivators such as rewards and punishments, we are teaching our children that their worth depends…The Loss of SadnessAccording to Horwitz and Wakefield, emotions like sadness and depression have a long evolutionary history in humans, suggesting that these…Against happinessEric G. Wilson proposes that our culture’s preoccupation with happiness has overshadowed the importance of melancholy, an emotion he…The Cure WithinAnne Harrington examines the roots of mind-body medicine, exploring how today’s alternative treatments, such as mindfulness meditation,…NudgeImproving decisions about health, wealth, and happiness, with a little nudge.
Pathological AltruismAltruism is good, but too much of it can trigger burnout--or worse--depression. "Hyperempathy" and "pathological" altruism make us sick and…SuperCooperatorsNovak re-tells the story of evolution as a story of cooperation, not competition, offering scientific and mathematical evidence that altruism…The Price of AltruismIf evolution has yielded goodness, then why wasn't Darwin concerned about the survival of the nicest? Harman tells a story of human kindness…Altruism in HumansWe lose time to save the whales and we lose sleep over a heartbroken friend. With this, Baston posits the remarkable thesis that we humans…NutureShockNurtureShock unravels how many of modern society's most popular strategies for raising children are in fact backfiring because key points in…The Joy DietTen daily practices for a happier life.
Learned OptimismAn absolute must-read for all persons interested in genuinely understanding and helping our fellow human beings.
Happiness: The Science Behind Your SmileNettle seeks out the reasons behind the lack of connection between the acquisition of material goods and happiness.
Positive Psychology at the MoviesNiemiec and Wedding use hundreds of films to illustrate some of strengths (e.g., bravery, curiosity) and virtues (e.g., temperance, wisdom)…The Optimistic ChildA proven program to safeguard children against depression and build lifelong resilience.
Mindful MotherhoodThis book highlights how mindfulness can help you approach every experience with your new baby with open eyes and an open heart.
Self-CompassionKristin Neff explains how to cultivate self-compassion and why it's so beneficial.
The Dalai Lama at MIT'The Dalai Lama at MIT' is a “broadcast” of an historic 2003 meeting between the Dalai Lama and 22 world-renowned scientists at the…Reconciliation in divided societiesErin Daly, a law professor at Widener University in Delaware, and Jeremy Sarkin, a professor and former judge in Cape Town, South Africa,…Buddah’s BrainRick Hanson and Richard Mendius show how buddhist practices strengthen positive neurochemical systems that determine how we feel about life,…ConnectedChristakis and Folwer guide us through the burgeoning field of social network science, offering sharp reminders of the extraordinary role…The Happiness ProjectRubin decides to work on changing one aspect of her life each month for a year, following a recipe for self-improvement culled from the works…The Upside of IrrationalityAriely, a professor of behavioral economics at Duke, reveals how we are not the rational, selfish beings some economists would have us…How Pleasure WorksBloom explores a broad range of human pleasures from food to sex to religion to music. Bloom argues that human pleasure is not purely an…The Mindful TherapistSiegel argues that the mindfulness and well-being of a therapist has a direct impact on the quality of treatment that he or she is able to…The Politics of HappinessAuthor and former Harvard president, Derek Bok, makes the case that findings from positive psychology should inform social policies, helping…Exploring HappinessBok draws on ideas from philosophy, economics, and psychology to offer an understanding of happiness and how we may go about getting more of…Alone TogetherTurkle illustrates how the lines between reality and virtual reality are becoming increasingly blurred.
Virtually YouAboujaoude, describes the ways we reinvent ourselves online and says that the problem with our “e-personality” is its intense focus on ourselves.
The Worry SolutionRossman attempts to show readers how to distinguish corrosive from helpful worrying, and how to handle each more effectively. His solution is…Join The ClubRosenberg, a Pulitzer Prize-winning journalist, delves deeply into stories of people who’ve developed savvy ways to exploit social,…Real HappinessShares the lessons and wisdom Salzberg has developed over 30 years of teaching meditation, distilled into a 28-day program.
The Science of EvilBaron-Cohen reports on what he has learned about the link between empathy and cruelty over more than two decades of research.
Rad Dad: Dispatches from the Frontiers of FatherhoodBestselling authors, writers, musicians, and others bring their voices together to explore the modern complexities of fatherhood. Co-edited…The Mindfulness RevolutionSome of the top experts on mindfulness explain what it is, why we should practice it, and how to apply it at work, at home, and beyond.
The Social Neuroscience of EmpathyThis edited volume takes a social neuroscience approach to empathy by examining empathy at multiple levels including biological, cognitive,…NurtureShock: New Thinking about ChildrenThe Middle PlaceLift: Children. Turbulence. Life.
The Optimistic Child: A Proven Program to Safeguard Children Against Depression and Build ...
Learned Optimism: How to Change Your Mind and Your LifeGeneration Me: Why Today’s Young Americans Are More Confident, Assertive, Entitled—& More MiserablePunished by Rewards: The Trouble with Gold Stars, Incentive Plans, A’s, Praise, and Other BribesWhy Good Things Happen to Good PeopleUnconditional Parenting: Moving from Rewards and Punishments to Love and ReasonBorn to Buy: The Commercialized Child and the New Consumer CultureAffluenza: The All-Consuming EpidemicThe High Price of MaterialismIn the Course of a Lifetime Tracing Religious Belief, Practice, and ChangeThe Optimistic ChildA proven program to safeguard children against depression and build life long resilience.
The Lonely AmericanPsychiatrists Jacqueline Olds and Richard Schwartz, describes America's obsession with living separately from others and the corresponding…The Joy DietNurtureShock: New Thinking about ChildrenThe Power of CompassionCompassion is powerful, but it is also contagious. Forty first-person stories make it abundantly clear that extraordinary acts of kindness…The Compassionate MindWe're angry, fearful, depressed--and we can't help it. Societies that encourage us to compete with each other make it difficult to exercise…The Mindful ChildGreenland offers a simple “how to” approach to mindfulness to parents who want to practice with their children.
Fully PresentSmalley highlights research encouraging readers to try mindfulness themselves, and Winston explains how.
A Call to CompassionDrawing on foundational texts across many world religions, Armstrong describes the building blocks of compassion and challenges readers to…Are We Born Racist? New Insights from Neuroscience and Positive PsychologyThis collection of essays, many of which first appeared inGreater Good, draws on cutting-edge science to explore the psychological roots of…Born for LoveSzalavitz and Perry examine the development of empathy in children, why it is crucial for society, and how it may be threatened in the modern world.
Raising Happiness: 10 Simple Steps for More Joyful Kids and Happier ParentsThe GGSC's Christine Carter distills the wisdom she has been sharing for years in her parenting blog, offering research-based tips for…Whistling VivaldiSteele offers studies and stories that show how stereotypes can affect group members' lives in subtle but powerful ways, especially when it…The Compassionate Instinct: The Science of Human GoodnessAn anthology of essays from the first five years ofGreater Goodmagazine, highlighting ground-breaking research and trailblazing ideas on…Living Life as a Thank YouPresents a simple, but comprehensive program for incorporating gratitude into one's life, and reaping the many benefits that come from doing so.
The Path to PurposeLooks at how children are hampered in their search for meaning, and how concerned adults can help them find it.
The Geography of BlissWeiner takes us on a journey around the world to discover what makes some cultural groups happier than others.
The Wise HeartJack Kornfield explains the Buddhist concept of mindfulness and how it can be used for personal transformation.
Why We CooperateNature and nurture interact to inform, and reform, cooperative behavior. Infants and apes are both able to share, but only the two-year-old…LonelinessCacioppo and Patrick explain how we are wired to read human faces for social cues, but that lonely people are less skilled at this and,…CounterclockwiseLanger argues that, as we grow older, our physical limitations are largely determined by the way we think about ourselves and what we're capable of.
PositivityFredrickson lays out the science of positivity in a book that promises to change the way people look at feeling good.
The Triple BindAccording to Hinshaw, girls are pressured to excel at both traditional "female" roles and traditional "male" roles, while being 100% perfect…Mirroring PeopleMarco Iacoboni, a leading neuroscientist, explains the groundbreaking research into mirror neurons, the "smart cells" in our brain that allow…Curious?Todd Kashdan writes on the benefits of curiosity, mindfulness, and embracing uncertainty through science, story, and practical exercises.
29 GiftsWalker’s life is in a downward spiral until she takes unusual advice from a friend: to give away 29 gifts in 29 days.
The Empathic CivilizationRifkin believes that we humans are in a race for survival in a world of crisis, dependent on our ability to organize around an empathic…The Age of EmpathyDe Waal shares stories of pets who comfort their distressed owners and indicate that the roots of empathy are not limited to humans, and in…The Daddy ShiftWhat happens when women go to work and men take care of children? This influential book from Greater Good Science Center editor Jeremy Adam…The Empathy Gap: Building Bridges to the Good Life and the Good SocietyTrout explains how our empathic wiring actually undermines the best interests of individuals and society. However, it is possible to bridge…Born to Be Good: The Science of a Meaningful LifeThe acclaimed book from Greater Good Science Center co-founder and faculty director Dacher Keltner, providing a thorough and engaging…Play = LearningHow play motivates and enhances children's cognitive and social-emotional growth.
The How of HappinessMuch of our happiness is within our power to control—roughly 40 percent, according to research by psychologist Sonja Lyubomirsky.
Beyond RevengeMcCullough argues that forgiveness is truly a biological adaptation, naturally selected for its benefits to us as individuals and as a species.
SparkRatey, a physician, argues that exercise has a “profound impact on cognitive abilities” and “is simply one of the best treatments we…Emotional Awareness: Overcoming the Obstacles to Psychological Balance and CompassionDialogue discussing how people can cultivate compassion, minimize the harmful effects of emotions like anger, and achieve balance in their…Building Emotional IntelligenceLantieri, with contributions from Daniel Goleman, offers practical techniques to help children calm their bodies and focus their minds.
Altruism, Intergroup Apology, Forgivness, and ReconciliationSamuel Oliner argues it's time for apology and forgiveness on a global scale.
HappinessHappiness documents not just what happy people have in common, but the concrete benefits of happiness. For starters, happy people are more…The Science of Compassionate Love: Theory, Research, and ApplicationsThis anthology of essays is grounded in current literature on altruism and compassionate love: the specific brand of love that is giving the…The Lucifer EffectWhat makes good people do bad things? How can moral people be seduced to act immorally? Zimbardo explores how we are all susceptible to the…The Homework MythWhy our kids get too much of a bad thing.
Mindset: The New Psychology of SuccessDweck shows that how we learn and grow is largely determined by whether we have a "fixed" or "growth" mindset. The good news is that most of…Social IntelligenceA groundbreaking synthesis of findings from social and biological sciences, revealing that we are “wired to connect” and our…When Parents HurtCompassionate strategies when you and your grown children don't get along.
HappierHappiness is a skill you can develop no matter how happy you currently are.
Thanks!How the science of gratitude can make you happier.
Forgive for LoveLuskin lays out a seven-step program designed to help long-term partners learn to forgive each other for simply being human.
GivingHow each of us can change the world. Clinton urges us to seek out what each of us, “regardless of income, available time, age, and…The Altruistic SpeciesBiology, psychology, philosophy, and religion all inform the answer to the age-old questions on altruism; on whether it is essential to the…The Mindful Way through DepressionThe book draws from both Eastern meditative traditions and cognitive therapy to create a mindful way out of depression.
The Mindful BrainDaniel shows readers how personal awareness and attunement can improve life by boosting well-being, resilience, emotional balance, and other…Why Good Things Happen to Good PeoplePost and Neimark make the case that giving to others—in small doses and from a young age—will help you “be happier… healthier… and…Train Your Mind, Change Your BrainBegley explains neuroplasticity: how experience can shape the brain’s structure—and, in turn, change the way our minds and bodies function.
The Power of PlayElkind argues that our fast-paced, screenladen, and safety-obsessed way of life is destroying spontaneous, creative, child-led play, with…The Brain That Changes ItselfExplores the significance of neuroplasticity, where thoughts and experience can change the shape of the brain over time, engaging the reader…The Hand of Compassion: Portraits of Moral Choice During the HolocaustThe Hand of Compassion is the latest of several books to use the Holocaust as a basis for studying altruism and compassion.
Happiness: Lessons From a New ScienceSince 1950, postwar capitalism has led to an unprecedented standard of living in the West. Yet it has not translated into an equal upsurge in…All RiseFuller's second book on "rankism," elaborating on his vision for replacing a “rankist” world with a “dignitarian” one, in which…Stumbling on HappinessDaniel Gilbert’s engaging and surprising new book, Stumbling on Happiness, won’t teach you how to become happy, but it will convince you…The Happiness HypothesisWhy do some people find meaning, purpose, and fulfillment in life while others do not? Jonathan Haidt’s book draws on ancient wisdom and…Happiness: A HistoryThroughout history happiness has been equated with the highest human calling, argues McMahon, and our modern belief of happiness is the…Critical LessonsNel Noddings advocates critical thinking and self-knowledge as the best ways to reinvigorate our woefully inadequate school systems.
The Anatomy of PeaceThis book demonstrates that treating others humanely can resolve conflict better than direct confrontation.
Help for the HelperThe authors examine the literature from neurobiology and social psychology to explain how therapists suffer from an excess of empathy for…Coming to Our SensesJon Kabat-Zinn expands upon the themes of his earlier books: that Buddhist-based meditation and mindfulness techniques can relieve stress and…Field Notes on the Compassionate Life: A Search for the Soul of KindnessField Notes on the Compassionate Life chronicles Barasch's attempts to better understand people who so powerfully embody the better side of…Roots of EmpathyMary Gordon explains how best to nurture empathy and social emotional literacy in all children—and thereby reduce aggression, antisocial…Our Inner ApeDe Waal insists that many positive human attributes—such as empathy, kindness, and altruism—are part of our animal heritage.
The Handbook of Positive PsychologyThe first systematic attempt to bring together leading scholars of the emerging field of positive psychology, this book gives readers an…Happiness and EducationWhen parents are asked what they want for their children, they usually answer that they want their children to be happy. Why, then, is…Do Unto OthersOliner explores why ordinary people perform extraordinary acts of courage, compassion, and self-sacrifice.
On ApologyExplains what makes an effective apology and explores apology's role in forgiveness and reconciliation.
Destructive EmotionsReporting on a ground-breaking dialogue between scientists and the Dalai Lama, this book explores how can we can develop peace with ourselves…The Psychology of GratitudeThis is a collection of academic articles on the science of gratitude.
Making GoodHarvard researchers explore how professional success and professional ethics don’t necessarily go hand-in-hand.
The Compassionate Classroom: Lessons That Nurture Wisdom and EmpathyDalton and Fairchild are interested in encouraging students to get to know and appreciate themselves, their community, and the world around them.
Leave No Child BehindComer offers a plan with real promise to improve the lives of children well beyond their time in the classroom.
Positive Psychology in PracticeThis book distinguishes itself by not only reporting on breakthroughs in positive psychology, but by emphasizing how these findings can be applied.
Kids Working it OutOffers educators and parents a guide to the most current and effective school-based conflict resolution programs, and shows how these…Forgiving and ReconcilingConsiders forgiveness as an act of altruism rather than a strictly personal benefit.
Forgive for GoodOutlines both the benefits of forgiveness and Luskin's nine-step method for giving up grudges.
FlourishingDistinguished scholars explore what it means to lead a life wel-lived, expanding the scope of psychological research to encompass happiness,…Authentic HappinessA foundational text in positive psychology, explaining how to realize your potential for lasting fulfillment.
Bowling AlonePutnam shows how we have become increasingly disconnected from one another and how social structures have disintegrated.
From Detached Concern to EmpathyHalpern considers ways for physicians to bring empathy into their practices to minimize the sense of detachment patients often feel while…Humanity: A Moral History of the Twentieth CenturyHiroshima and the Holocaust have something in common, andHumanitysets out to exploit the disturbing similarities in ways that can…Helping Clients ForgiveDiscusses forgiveness in psychotherapeutic and clinical settings.
The Seven Principles for Making Marriage WorkIt only takes Gottman five minutes to predict, with 91 percent accuracy, which couples will eventually divorce.
No Future Without ForgivenessTutu urges forgiveness as a way to peace, even in the wake of atrocities.
Punished by RewardsKohn discusses why rewards, including praise, fail to promote lasting behavior change or enhance performance and frequently make things worse.
Exploring ForgivenessA collection of essays that offer different perspectives on forgiveness, from the scientific to the personal.
The Art of HappinessA handbook for living. This is the book that kicked off the genre of happiness books, and it remains a cornerstone of the field of positive…Everyday BlessingsThe inner workings of mindful parenting of children of all ages.
Raising An Emotionally Intelligent ChildThis is a great book for learning how to emotion coach your child, written by a highly regarded researcher.
Unto OthersUnselfish behavior exists--without pretense and without hidden motives. Our capacity for generosity as a goal in itself is the most important…Why Are All the Black Kids Sitting Together in the Cafeteria?An expert on the psychology of racism argues that our discomfort broaching the subject of race exacerbates racial divisions and inequalities.
Emotional IntelligenceThis is the seminal book on emotional intelligence, written for a general audience.
Toward a Caring SocietyPromoting a sense of personal responsibility for the well-being of others is perhaps the greatest moral challenge we face. And making our…Wherever You Go, There You AreSequel to "Full Catastrophe Living," Jon further delves into meditation and mindfulness theory.
The Altruistic PersonalityWhy, during the Holocaust, did some people risk their lives to help others while some stood passively by? Samuel Oliner, a Holocaust…Peace is Every StepThich Nhat Hanh shows us how to make positive use of the very situations that usually pressure and antagonize us through mindful practices.
Full Catastrophe LivingUsing the wisdom of your body and mind to face stress, pain, and illness.
FlowFlow, a state of deep enjoyment, creativity, and total involvement with life, is something we can cultivate with practice, according to this…Forgive and ForgetDiscusses the role of forgiveness in healing after others hurt us.
The Greater Good Science Center studies the psychology, sociology, and neuroscience of well-being, and teaches skills that foster a thriving, resilient, and compassionate society.
© 2022 The Greater Good Science Center at the University of California, Berkeley
